NO ./textures/north.xpm
SO ./textures/south.xpm
WE ./textures/west.xpm
EA ./textures/east.xpm

F 155,118,83
C 0,17,28

1111111111111111
1000000000000001
1011001101111001
1011111100011001
1000011101100001
1000011101111001
1000000000000001
1000000000000001
1000000000000001
1000000N00000001
1111111111111111