NO ./textures/east.xpm
SO ./textures/east.xpm
WE ./textures/east.xpm
EA ./textures/east.xpm

F             155,118,83
C 135,206,235

11111
10001
10E01
10001
10001
10001
10001
10001
10001
10001
10001
11111