NO ./textures/north.xpm
SO ./textures/south.xpm
WE ./textures/west.xpm
EA ./textures/east.xpm

F             155,118,83
C 135,206,235

111111111
100000001
1111111111111111111111111
1000000000110000000000001
1000000000110000000000001
1000000000000000000000001
1000000000000001111111111
1000000000000001100000001
1000000000000000000000001
1000000000000000000000001
1000000000000000000000001
1000000000000000000000001
1111111100000000000000001
       1000000000000000001
1111111100000000000000001
1000000000000000000000001
1000000000000000000000001
1000000000000N00000000001
1000000000000000000000001
1000000000000000000000001
1000000000000000000000001
1000000000000000000000001
1000000000000000000000001
1000000000000000000000001
1000000000001100000000001
1000000000001100000000001
1000000000001100000000001
1111111111111111111111111
