NO ./textures/north.xpm
SO ./textures/south.xpm
WE ./textures/west.xpm
EA ./textures/east.xpm

F             155,118,83
C 135,206,235

111111111111111111111111111111111111
100000000000000000000000000000000001
110010000000100000000000000000000001
100010001000000010000000000000000001
100000000000000000000000000000000001
110101010100100000000000000000000001
100000000000000000000000000000000001
10000N000000000000000000011000000001
110000000000100000000000011100000001
100000000000000010000000000000000001
100000000000000010000000000001000001
100000000000001100000000000000010001
100000000001110000000010000100000001
100011000100001000001100000000100001
100001010001000000000000000000000001
100001000000001001000000000000000001
100000000100100000000000000010000001
101001000000000110000000000000100001
100000000001000000000000000000000001
111111111111111111111111111111111111
