NO ./path_to_the_north_texture
SO ./path_to_the_south_texture
WE ./path_to_the_west_texture
EA ./path_to_the_east_texture

F 220,40,0
C 225,30,0

111111111
100000001
1111111111111111111111111
1000000000110000000000001
1000000000110000000000001
1000000000000000000000001
1000000000000001111111111
1000000000000001100000001
1000000000000000000000001
1000000000000000000N00001
1000000000001100000000001
1000000000001100000000001
1000000000001100000000001
1111111111111111111111111


